NO ressources/xpm/utils/lb_NORTH.xpm







SO ressources/xpm/utils/lb_SOUTH.xpm





WE ressources/xpm/utils/lb_EAST.xpm







EA ressources/xpm/utils/lb_WEST.xpm













F 180,100,130
C 50,20,155
B 0,0,0
111111
100001
10N001
100001
100001
111111














