NO ressources/xpm/utils/lb_NORTH.xpm
SO ressources/xpm/utils/lb_SOUTH.xpm
WE ressources/xpm/utils/lb_EAST.xpm
EA ressources/xpm/utils/lb_WEST.xpm
F 96,64,32
C 32,64,128





11111
0001111111111
0N01111111111
11111