NO ressources/xpm/utils/NORTH.xpm
SO ressources/xpm/utils/SOUTH.xpm
WE ressources/xpm/utils/EAST.xpm
EA ressources/xpm/utils/WEST.xpm
F 180,100,130
C 50,20,155
B 0,0,0
11111111111111111111111111111111111111111111111111
13333333333333333333333333333333333333333333333331
13444444444444444444444444444444444444444444444431
13455555555555555555555555555555555555555555555431
13456666666666666666666666666666666666666666665431
13456777777777777777777777777777777777777777765431
13456788888888888888888888888888888888888888765431
13456789999999999999999999999999999999999998765431
13456789999999999999999999999999999999999998765431
13456789999999999999999999999999999999999998765431
13456789999999999999999999999999999999999998765431
13456789999999999999999999999999999999999998765431
13456789999999999999999999999999999999999998765431
13456789999999999999999999999999999999999998765431
134567899999999999999999N9999999999999999998765431
13456789999999999999999999999999999999999998765431
13456789999999999999999999999999999999999998765431
13456789999999999999999999999999999999999998765431
13456789999999999999999999999999999999999998765431
13456788888888888888888888888888888888888888765431
13456777777777777777777777777777777777777777765431
13456666666666666666666666666666666666666666665431
13455555555555555555555555555555555555555555555431
13444444444444444444444444444444444444444444444431
13333333333333333333333333333333333333333333333331
11111111111111111111111111111111111111111111111111