NO ressources/xpm/utils/NORTH.xpm
SO ressources/xpm/utils/SOUTH.xpm
WE ressources/xpm/utils/EAST.xpm
EA ressources/xpm/utils/WEST.xpm
F 200,100,100
C 200,200,150
B 200,200,100

111111111111111111111111111111111111111
100000000000000000000000000000000000001
100000000000000000000000000000000M00001
100000000000000000000000000000000000001
100000000000000000000000000000000000001
100000000000111111111111111000000000001
1000M0000000133333333333331000000000001
100000000000134444444444431000000000001
100000000000134555555555431000000000001
100000000000134566666665431000000000001
100000000000134567777765431000000000001
100000000000134567888765431000000000001
100000000000134567808765431000000000001
100000000000134567888765431000000000001
100000000000134567777765431000000000001
100000000000134566666665431000000000001
100000000000134555555555431000000000001
100000000000134444444444431000000000001
100000000000133333333333331000000000001
100000000000111111131111111000000000001
100000000000000000000000000000000000001
100000011100000000000000013111000000001
1000000111131000000M0000001341000000001
100000011114310000000000013451000000M01
100000011115431000000000134561000000001
100000011116543100000001345671000000001
100000011117654310000013456781000000001
100000011198765431000134567891000000001
100000011198765431000134567891000000001
100000011198765431000134567891000000001
100000031198765431000134567893000000001
100000011198765431000134567891000000001
100000011198765431000134567891000000001
100000011198765431000134567891000000001
100000011198765431101134567891000000001
1000M0011119876543101345678911000000001
100000011111987654303456789111000000001
100000011111198765404567891111000000001
100000011111198765404567891111000000001
100000011111198765404567891111000000001
100000011111187654303456781111000000001
100000011111176543101345671111000000001
100000011111165431000134561111000000001
100000011111154310000013456111000000001
10000M011111143100000001345111000000001
100000011111131000000000131111000000001
100000011111110000000000011111000000001
100000011111100000000000001111000000001
100000011111000000000000000111000000001
100000011110000001000100000011000000001
100000011100000003000300000001000000001
100000011000000004000400000001000000001
100000010000000005000500000001000000001
10000001000000000600060000000100000M001
100000000000000005000500000000000000001
100000440000000004000400000000000000001
100000440000000003000300000000000000001
10M008880000000001000100000000000000001
100008880000000000000000000000550000001
100008880000000000000000000000550000001
100000000000000000000000000000000000001
1000000000000000000N0000000000000000001
111111111111111111111111111111111111111