NO ressources/xpm/utils/NORTH.xpm
SO ressources/xpm/utils/SOUTH.xpm
WE ressources/xpm/utils/EAST.xpm
EA ressources/xpm/utils/WEST.xpm
F 180,100,130
C 50,20,155
B 0,0,0

11111111111111111111111111111111111111111111111111111111111111111111111111111111111111111111
13333333333333333333333333333333333333333333333333333333333333333333333333333333333333333331
13E44444444444444444444444444444444444444444444444444444444444444444444444444444444444444431
13333333333333333333333333333333333333333333333333333333333333333333333333333333333333333331
11111111111111111111111111111111111111111111111111111111111111111111111111111111111111111111