NO ressources/xpm/utils/EAST.xpm
SO ressources/xpm/utils/EAST.xpm
WE ressources/xpm/utils/EAST.xpm
EA ressources/xpm/utils/EAST.xpm

FLOR ressources/xpm/utils/floor.xpm
CEIL ressources/xpm/utils/NORTH.xpm
HOUS ressources/xpm/utils/EAST.xpm

F 50,20,30
C 10,10,10
B 0,0,0

111111111111111111111111111111111111111
100000000000000000000000000000000000001
100000000000000000000000000000000000001
100000000000000000000000000000000000001
100000000000000000000000000000000000001
100000111111110000000000000000000000001
100000100000010000000000000000000000001
1000001000000D00000000W0000000000000001
100000100000010000000000000000000000001
100000111111110000000000000000000000001
100000000000000000000000000000000000001
100000000000000000000000000000000000001
100000000000000000000000000000000000001
100000000000000000000000000000000000001
100000000000000000000000000000000000001
100000000000000000000000000000000000001
111111111111111111111111111111111111111