NO ressources/xpm/utils/lb_NORTH.xpm
SO ressources/xpm/utils/lb_SOUTH.xpm
WE ressources/xpm/utils/lb_EAST.xpm
EA ressources/xpm/utils/lb_WEST.xpm
F 96,64,32
C 32,64,128


1        1       111
     1        1  101
            1    111
1111
10P1     1    111111111
1011          100E00001
101           10E00EEE1
101           111111101
101                 101
101           11111110111111111111111111111
101           10000000000000000000000000001
101    1       100000000000000000000000001
101             1000000000000000000000001
101              10000000000000000000001
101               100000000000000000001
101                1000000000000000001
101                 10000000000000001
101  1               100000000000001
101                   1000000000001
101                    10000000001
101                     100000001
101                      1000001
101                       10001
101                        101
101                       10001
101                      1000001
101                     100000001
10111111111111         10000000001
100000000000P1        1000000000001
10111111111111       100000000000001
101                 10000000000000001
101                1000000000000000001
101               100000000000000000001
101              10000000000000000000001
101             1000000000000000000000001
101111111111111100000000000000000000000001
1000000000000000000000000000000000000000001
1111111111111111111111111111111111111111111
