NO ressources/xpm/utils/NORTH.xpm
SO ressources/xpm/utils/SOUTH.xpm
WE ressources/xpm/utils/EAST.xpm
EA ressources/xpm/utils/WEST.xpm
F 60,80,40
C 110,164,230

      11111    
    110PPPP11    
   100K000K001  
  1PPGGG0P0B001 
 1000GGG0000P001
100B0222D22200M01
100002PPPPP200001
10P002PK00P200001
10K00DK0N0PD00001222222211
10M002P0M0P20P00D0000000D01
1T0002KPP0P2000012222222101
10000222D22200001       101
 100000000000001        101
  10P00000P0001         101
   100K000K001          101
    1T0000001111111111112D2
     11111100000M0000000001
           111111111111111