NO ressources/xpm/utils/NORTH.xpm
SO ressources/xpm/utils/SOUTH.xpm
WE ressources/xpm/utils/EAST.xpm
EA ressources/xpm/utils/WEST.xpm
F 200,100,100
C 200,200,150
B 200,200,100


111111111111111111111111111111111111
1888888888888888888888888888888888811
1888888888888888888888888888888888831
1888888888888888888888888888888888841
1888888888888888888888888888888888851
1888888888888888888888888888888888861
1888888888888888888888888888888888871
1888888888888888888888888888888888881
1888888888888888888888888888888888881
1888888888888888888888888888888888881
1888888888888888888888888888888888881
1888888888888888888888888888888888881
188888888888888888N888888888888888881
1888888888888888888888888888888888881
1888888888888888888888888888888888881
1888888888888888888888888888888888881
1888888888888888888888888888888888881
1888888888888888888888888888888888881
1888888888888888888888888888888888881
1888888888888888888888888888888888881
1888888888888888888888888888888888881
111111111111111111111111111111111111