NO ressources/xpm/utils/NORTH.xpm
SO ressources/xpm/utils/SOUTH.xpm
WE ressources/xpm/utils/EAST.xpm
EA ressources/xpm/utils/WEST.xpm
F 200,100,100
C 200,200,150
B 200,200,100

111111111111111111111111111111111111111
1T00000000000000000000000000000000000T1
100000000K00000000000P00000000000M00001
100000000000000000000000000000000000001
10000K000000000000000000000000000000001
100000000000111111111111111000000000001
1000M0000000133333333333331000000000001
1000000000001344444444444310000000P0001
100000000000134555555555431000000000001
1000000P0000134566666665431000000000001
100000000000134567777765431000000000001
100000000000134567888765431000000000001
1000000000001345678K8765431000000000001
100000000000134567888765431000000000001
100000000000134567777765431000000000001
100000000000134566666665431000000000001
100000000000134555555555431000000000001
100000000000134444444444431000000000001
100000000000133333333333331000000000001
1000000000001111111D1111111000000000001
100000000000000000000000000000000000001
100000011100000000000000013111000000001
1000000111131000000M0000001343100000001
100000011134310000000000013454310000M01
100000011345431000000000134565431000001
100000013456543100000001345676543100001
100000134567654310000013456787654310001
100001345678765431000134567898765431001
100011345678765431000134567898765431001
100134567898765431000134567898765431001
101134567898765431000134567898765431001
100134567898765431000134567898765431001
100134567898765431000134567898765431001
100134567898765431101134567898765431001
100013456789876543101345678987654310001
100001345678987654303456789876543100001
100000134567898765404567898765431000001
100000134567898765404567898765431000001
100000134567898765404567898765431000001
1000000134567876543034567876543100000B1
100000011345676543101345676543100000001
100000011134565431000134565431000000001
100K000111134543100000134543110000K0001
10000M011111343100000001343111000000001
100000011111131000000000131111000P00001
100M000111111100000P00000111110000000B1
100000011111100000000000001111000000001
100000011111000000000000000111000000001
10000001111000000100010000001100000K001
100P00011100000003000300000001000000001
100000011000000004000400000001000000001
100000010000000005000500000001000000001
10000001000000000600060000000100000M001
100000000000000005000500000000000000001
1000004400P0000004000400000000000000001
100000440000000003000300000000000K00001
10M008880000000001000100000000000000001
100008880000000000000000000000550000001
100008880P00000000000000000000550000001
100000K00000000000000000000000000K00001
1B00000000000000000N00000000000000000T1
111111111111111111111111111111111111111