NO ressources/xpm/utils/NORTH.xpm
SO ressources/xpm/utils/SOUTH.xpm
WE ressources/xpm/utils/EAST.xpm
EA ressources/xpm/utils/WEST.xpm
F 180,100,130
C 50,20,155
B 0,0,0
111111
133331
13N431
134431
133331
111111